1111111111
1W11111111
1W11111111
1W11111111
1W11111111
1W11111111
1W11111111
1WWWWWWWWW
1WWWWWWWW1
1111111111
