111111111111111111111111111111111111111111111111111111111111111111111111111111111111111111111111111111
1W0000000000000000000000000000000000000000000000000000000000000000000000000000000000000000000000000001
1W0000000000000000000000000000000000000000000000000000000000000000000000000000000000000000000000000001
1W0000000000000000000000000000000000000000000000000000000000000000000000000000000000000000000000000001
1W0000000000000000000000000000000000000000000000000000000000000000000000000000000000000000000000000001
1W0000000000000000000000000000000000000000000000000000000000000000000000000000000000000000000000000001
1W0000000000000000000000000000000000000000000000000000000000000000000000000000000000000000000000000001
1W0000000000000000000000000000000000000000000000000000000000000000000000000000000000000000000000000001
1W0000000000000000000000000000000000000000000000000000000000000000000000000000000000000000000000000001
1W0000000000000000000000000000000000000000000000000000000000000000000000000000000000000000000000000001
1W0000000000000000000000000000000000000000000000000000000000000000000000000000000000000000000000000001
1W0000000000000000000000000000000000000000000000000000000000000000000000000000000000000000000000000001
1W0000000000000000000000000000000000000000000000000000000000000000000000000000000000000000000000000001
1W0000000000000000000000000000000000000000000000000000000000000000000000000000000000000000000000000001
1W0000000000000000000000000000000000000000000000000000000000000000000000000000000000000000000000000001
1W0000000000000000000000000000000000000000000000000000000000000000000000000000000000000000000000000001
1W0000000000000000000000000000000000000000000000000000000000000000000000000000000000000000000000000001
1W0000000000000000000000000000000000000000000000000000000000000000000000000000000000000000000000000001
1W0000000000000000000000000000000000000000000000000000000000000000000000000000000000000000000000000001
1W0000000000000000000000000000000000000000000000000000000000000000000000000000000000000000000000000001
1W0000000000000000000000000000000000000000000000000000000000000000000000000000000000000000000000000001
1W0000000000000000000000000000000000000000000000000000000000000000000000000000000000000000000000000001
1W0000000000000000000000000000000000000000000000000000000000000000000000000000000000000000000000000001
1W0000000000000000000000000000000000000000000000000000000000000000000000000000000000000000000000000001
1W0000000000000000000000000000000000000000000000000000000000000000000000000000000000000000000000000001
1W0000000000000000000000000000000000000000000000000000000000000000000000000000000000000000000000000001
1W0000000000000000000000000000000000000000000000000000000000000000000000000000000000000000000000000001
1W0000000000000000000000000000000000000000000000000000000000000000000000000000000000000000000000000001
1W0000000000000000000000000000000000000000000000000000000000000000000000000000000000000000000000000001
1W0000000000000000000000000000000000000000000000000000000000000000000000000000000000000000000000000001
1W0000000000000000000000000000000000000000000000000000000000000000000000000000000000000000000000000001
1W0000000000000000000000000000000000000000000000000000000000000000000000000000000000000000000000000001
1W0000000000000000000000000000000000000000000000000000000000000000000000000000000000000000000000000001
1W0000000000000000000000000000000000000000000000000000000000000000000000000000000000000000000000000001
1W0000000000000000000000000000000000000000000000000000000000000000000000000000000000000000000000000001
1W0000000000000000000000000000000000000000000000000000000000000000000000000000000000000000000000000001
1W0000000000000000000000000000000000000000000000000000000000000000000000000000000000000000000000000001
1W0000000000000000000000000000000000000000000000000000000000000000000000000000000000000000000000000001
1W0000000000000000000000000000000000000000000000000000000000000000000000000000000000000000000000000001
1W0000000000000000000000000000000000000000000000000000000000000000000000000000000000000000000000000001
1W0000000000000000000000000000000000000000000000000000000000000000000000000000000000000000000000000001
1W0000000000000000000000000000000000000000000000000000000000000000000000000000000000000000000000000001
1W0000000000000000000000000000000000000000000000000000000000000000000000000000000000000000000000000001
1W0000000000000000000000000000000000000000000000000000000000000000000000000000000000000000000000000001
1W0000000000000000000000000000000000000000000000000000000000000000000000000000000000000000000000000001
1W0000000000000000000000000000000000000000000000000000000000000000000000000000000000000000000000000001
1W0000000000000000000000000000000000000000000000000000000000000000000000000000000000000000000000000001
1W0000000000000000000000000000000000000000000000000000000000000000000000000000000000000000000000000001
1W0000000000000000000000000000000000000000000000000000000000000000000000000000000000000000000000000001
1W0000000000000000000000000000000000000000000000000000000000000000000000000000000000000000000000000001
1W0000000000000000000000000000000000000000000000000000000000000000000000000000000000000000000000000001
1W0000000000000000000000000000000000000000000000000000000000000000000000000000000000000000000000000001
1W0000000000000000000000000000000000000000000000000000000000000000000000000000000000000000000000000001
1W0000000000000000000000000000000000000000000000000000000000000000000000000000000000000000000000000001
1W0000000000000000000000000000000000000000000000000000000000000000000000000000000000000000000000000001
1W0000000000000000000000000000000000000000000000000000000000000000000000000000000000000000000000000001
1W0000000000000000000000000000000000000000000000000000000000000000000000000000000000000000000000000001
1W0000000000000000000000000000000000000000000000000000000000000000000000000000000000000000000000000001
1W0000000000000000000000000000000000000000000000000000000000000000000000000000000000000000000000000001
1W0000000000000000000000000000000000000000000000000000000000000000000000000000000000000000000000000001
1W0000000000000000000000000000000000000000000000000000000000000000000000000000000000000000000000000001
1W0000000000000000000000000000000000000000000000000000000000000000000000000000000000000000000000000001
1W0000000000000000000000000000000000000000000000000000000000000000000000000000000000000000000000000001
1W0000000000000000000000000000000000000000000000000000000000000000000000000000000000000000000000000001
1W0000000000000000000000000000000000000000000000000000000000000000000000000000000000000000000000000001
1W0000000000000000000000000000000000000000000000000000000000000000000000000000000000000000000000000001
1W0000000000000000000000000000000000000000000000000000000000000000000000000000000000000000000000000001
1W0000000000000000000000000000000000000000000000000000000000000000000000000000000000000000000000000001
1W0000000000000000000000000000000000000000000000000000000000000000000000000000000000000000000000000001
1W0000000000000000000000000000000000000000000000000000000000000000000000000000000000000000000000000001
1W0000000000000000000000000000000000000000000000000000000000000000000000000000000000000000000000000001
1W0000000000000000000000000000000000000000000000000000000000000000000000000000000000000000000000000001
1W0000000000000000000000000000000000000000000000000000000000000000000000000000000000000000000000000001
1W0000000000000000000000000000000000000000000000000000000000000000000000000000000000000000000000000001
1W0000000000000000000000000000000000000000000000000000000000000000000000000000000000000000000000000001
1W0000000000000000000000000000000000000000000000000000000000000000000000000000000000000000000000000001
1W0000000000000000000000000000000000000000000000000000000000000000000000000000000000000000000000000001
1W0000000000000000000000000000000000000000000000000000000000000000000000000000000000000000000000000001
1W0000000000000000000000000000000000000000000000000000000000000000000000000000000000000000000000000001
1W0000000000000000000000000000000000000000000000000000000000000000000000000000000000000000000000000001
1W0000000000000000000000000000000000000000000000000000000000000000000000000000000000000000000000000001
1W0000000000000000000000000000000000000000000000000000000000000000000000000000000000000000000000000001
1W0000000000000000000000000000000000000000000000000000000000000000000000000000000000000000000000000001
1W0000000000000000000000000000000000000000000000000000000000000000000000000000000000000000000000000001
1W0000000000000000000000000000000000000000000000000000000000000000000000000000000000000000000000000001
1W0000000000000000000000000000000000000000000000000000000000000000000000000000000000000000000000000001
1W0000000000000000000000000000000000000000000000000000000000000000000000000000000000000000000000000001
1W0000000000000000000000000000000000000000000000000000000000000000000000000000000000000000000000000001
1W0000000000000000000000000000000000000000000000000000000000000000000000000000000000000000000000000001
1W0000000000000000000000000000000000000000000000000000000000000000000000000000000000000000000000000001
1W0000000000000000000000000000000000000000000000000000000000000000000000000000000000000000000000000001
1W0000000000000000000000000000000000000000000000000000000000000000000000000000000000000000000000000001
1W0000000000000000000000000000000000000000000000000000000000000000000000000000000000000000000000000001
1W0000000000000000000000000000000000000000000000000000000000000000000000000000000000000000000000000001
1W0000000000000000000000000000000000000000000000000000000000000000000000000000000000000000000000000001
1W0000000000000000000000000000000000000000000000000000000000000000000000000000000000000000000000000001
1W0000000000000000000000000000000000000000000000000000000000000000000000000000000000000000000000000001
1W0000000000000000000000000000000000000000000000000000000000000000000000000000000000000000000000000001
1W0000000000000000000000000000000000000000000000000000000000000000000000000000000000000000000000000001
1W0000000000000000000000000000000000000000000000000000000000000000000000000000000000000000000000000001
1WWWWWWWWWWWWWWWWWWWWWWWWWWWWWWWWWWWWWWWWWWWWWWWWWWWWWWWWWWWWWWWWWWWWWWWWWWWWWWWWWWWWWWWWWWWWWWWWWWWW1
111111111111111111111111111111111111111111111111111111111111111111111111111111111111111111111111111111
